00000000000000000000000000000000000000000000000000
01111111111111111011111111111111111111101111111110
01111111110000000000000000111111111111101111111110
01111111110000000000000000111111111111101111111110
01111111110000000000000000111111111111101111111110
01111111110000000000000000111111111111101111111110
01111111110000000000000000111110000000001111111110
01111111110000000000000000111110111111111111111110
01111111111111111111111111111110111111111111111110
01111111111111111111111111111110111111111111111110
00000000000000000000011111111110111111111111111110
01111111111111111111111111111110111111111100000000
01111111111111011111111111111110111111111111111S10
011111111111110G1111111111111110111111111111111110
01111110000000000000000000000000000000001111111110
01111110111111111111111111111111111111111111111110
01111110111111111111111111111111111111111111111110
01111110111111111111111011111111111111111111111110
01111110111111111111111011111111111111111111111110
01111110111111111111110000000000000000000011111110
01111110111111111111110111111111111111111111111110
01111110111111111111110111111111111111111111111110
01111111111111111111110111111111111111111111111110
01111111111111111111110111111111111111111111111110
00000000000000000000000000000000000000000000000000